 _______________________________________________________________________________________________________________________________________________________________________________________________________________
|~~~~~~~~~~~~~~~~~~~~~~~~~~~~~~~~~~\    \| /_____~~~~~~~~~~~~~~~~~~~~~~~~~~~~~~~~~~~~~~~~~~~~~~~___~|~_~~~~~~~~~~~~~~~~~~~~~~~~~~~~~~____/                |                 |                 |                 |
|~~~~~~~~~~~~~~~~~~~~~~~~~~~~~~~~~~/            /~~~~~~~~~~~~~~~~~~~~~~~~~~~~~~~~~~~~~~~~~~~___/   \_/ \___~~~~~~~~~~A:A~BAR~~~~~___/                     |  Orders         |  Spring 1901    |  Winter 1900    |
|~~~~~~~~~~~~~~~~~~~~~~~~~~~~~~~~~~\_         _/~~~~~~~~~~~~~~~~~~~A:A~~~~~~~~~~~~~~~~~~~~~/        ____   \___________~~~~~~~~~/                         |_________________|_________________|_________________|
|~~~~~~~~~~~~~~~~~~~~~~~~~~~~~~~~~~~~\_______/~~~~~~~~~~~~~~~~~~~~~NWY~~~~~~~~~~~~~~~~~~~~/    ____/    \__/           \___~~~~~\_                        |                 |                 |                 |
|~~~~~~~~~~~~~~~~~~~~~~~~~~~~~~~~~~~~~~~~~~~~~~~~~~~~~~~~~~~~~~~~~~~~~~~~~~~~~~~~~~~~~~~~|    /    \       \               \~~~~~~|                       |  A:A Aaa > Aaa  |  A:A Aaa > Aaa  |  A:A Aaa > Aaa  |
|~~~~~~~~~~~~~~~~~~~~~~~~~~~~~~~~~~~~~~~~~~~~\~~~~~~~~~~~~~~~~~~~~~~~~~~~~~~~~~~~~~~~___/    /      |       \      ________/~~~~~/                        |  A:A Aaa > Aaa  |  A:A Aaa > Aaa  |  A:A Aaa > Aaa  |
|~~~~~~~~~~~~~~~~~~~~~~~~~~~~~~~~~~~~~~~~~~~~~~~~~~~~~~~~~~~~~~~~~~~~~~~~~~~~~~~~___/       /       |___     |    /_~~~~~~~~~~~_/___                      |  A:A Aaa > Aaa  |  A:A Aaa > Aaa  |  A:A Aaa > Aaa  |
|~~~~~~~~~~~~~~~~~~~~~~~~~~~~~~~~~~~~~~~~~~~~~|~~~~~~~~~~~~~~__~~__~~__~~~~~~___/        __/       /~~~~\     \     \___~~~___/     \__                   |  A:A Aaa > Aaa  |  A:A Aaa > Aaa  |  A:A Aaa > Aaa  |
|~~~~~~~~~~~~~~~~~~~~~~~~~~~~~~A:A~~~~~~~~~~~~~~~~~~~~~~~~/~~~~~~~~~~~~~\~~_/          _/        _|~~~~~~|     \_       \_/            \                  |  A:A Aaa > Aaa  |  -------------  |  -------------  |
|~~~~~~~~~~~~~~~~~~~~~~~~~~~~~~NAO~~~~~~~~~~~~|~~~~~~~~~~~~~~~~~~~~~~~~~~~/    A:A    /         /~~~~~~~/        \   nc                 \_                |  A:A Aaa > Aaa  |  A:A Aaa > Aaa  |  A:A Aaa > Aaa  |
|~~~~~~~~~~~~~~~~~~~~~~~~~~~~~~~~~~~~~~~~~~~~~~____~~~~~/~~~~~~~~~~~~~~~~/    Nor    /       __/~~~~~~~|   A:A    |                       \_              |  A:A Aaa > Aaa  |  A:A Aaa > Aaa  |  A:A Aaa > Aaa  |
|~~~~~~~~~~~~~~~~~~~~~~~~~~~~~~~~~~~~~~~~~A:A~|   |\___~~~~~~~~~~~~~~~~~|          _/       |~~~~~~~~~~/   Fin    |                         \             |  A:A Aaa > Aaa  |  A:A Aaa > Aaa  |  A:A Aaa > Aaa  |
|~~~~~~~~~~~~~~~~~~~~~~~~~~~~~~~~~~~~~~~~~~~_Cly /  Edi~~~~~~~~A:A~~~~~~~\_    * _/          \~~~A:A~~|        __/    A:A                 ___\__          |  A:A Aaa > Aaa  |  -------------  |  -------------  |
|~~~~~~~~~~~~~~~~~~~~~~~~~~~~~~~~~~~~~~__~~~\ __| * /~A:A~~~~~~NOR~~~~~~~~~\____/     A:A   * |~~GOB~~~\______/~~\    Stp              __/      \_        |  A:A Aaa > Aaa  |  A:A Aaa > Aaa  |  A:A Aaa > Aaa  |
|~~~~~~~~~~~~~~~~~~~~~~~~~~~~~~~~~~___/  \~_~\   \_|~~~~~~~~~~~~~~~~~~~~~~|~~~~~\     Swe   _/~~~~~~~~~~~________/*               ____/           \       |  A:A Aaa > Aaa  |  A:A Aaa > Aaa  |  A:A Aaa > Aaa  |
|~~~~~~~~~~~~~~~~~~~~~~~~~~~~~~~~~/      /~~~~|* |  \~~~~~~~~~~~~__~~__~~__~~A:A~\         /~~~~~~~~~~~_/     |   sc       ______/                 \      |  A:A Aaa > Aaa  |  A:A Aaa > Aaa  |  A:A Aaa > Aaa  |
|~~~~~~~~~~~~~~~~~~~~~~~~~~~~~~~~/     _/~A:A~Lvp/ Yor~A:A~~~~~~~~~~~~~~/  \__SKA~|       /~\~~__~~~~~/        \       ___/                         \     |  A:A Aaa > Aaa  |  -------------  |  -------------  |
|~~~~~~~~~~~~~~~~~~~~~~~__~~__~~|_____/~~~~__/__/____|~~~~~~~~~~|~~A:A~| A:A /~~_~|     _|~~~~~~~~~\~/   A:A    |  ___/                              |    |  A:A Aaa > Aaa  |  A:A Aaa > Aaa  |  A:A Aaa > Aaa  |
|~~~~~~~~~~~~~~~~~~~~/~~~~~~~~~~~~~~~~~~__/      /   \_~~~~~~~~~~~~HEL~| Den *|=\|=\___/~~~A:A~~~~__|   Liv     |_/                                  |    |  A:A Aaa > Aaa  |  A:A Aaa > Aaa  |  A:A Aaa > Aaa  |
|~~~~~~~~~~~~~~~~~~~~~~~~~~~A:A~~~~~~~~/_ A:A  _/ A:A  |~~~~~~~~|~~~~_~~\__ _/~~~~~~~~~~~~BAL~~~~/             /                  *                   \   |  A:A Aaa > Aaa  |  A:A Aaa > Aaa  |  A:A Aaa > Aaa  |
|~~~~~~~~~~~~~~~~~~/~~~~~~~~IRE~~~~~~~~_/ Wal | Lon *_/~~~~~~_______/ \_/==|_~~~~___~~~~~~~~~~~_/ \        ___/               A:A Mos                  |  |  A:A Aaa > Aaa  |  -------------  |  -------------  |
|~__~~__~~__~~__~~__~~__~~__~~__~~__~~/_______|_____\~~~~~__/  A:A  |     *  \__/   \_________/    |    __/                                       _____|  |  A:A Aaa > Aaa  |  A:A Aaa > Aaa  |  A:A Aaa > Aaa  |
|~~~~~~~~~~~~~~~~~~~~~~~~~~~~~~~~~~~~~~~~~~A:A~~~~~~~\___/ | * Hol /  A:A   _/   A:A     |  A:A   /____/                                    _____/      \ |_________________|  A:A Aaa > Aaa  |  A:A Aaa > Aaa  |
|~~~~~~~~~~~~~~~~~~~~~~~~\~~__~~__~~____~~~CHA~~_____/ A:A  \_____/  Kie __/   * Ber    /   Pru  /     \__     ___                _________/             \____              |  A:A Aaa > Aaa  |  A:A Aaa > Aaa  |
|~~~~~~~~~~~~~~~~~~~~~~~~~~~~~~~~~~/ *  \______/ A:A \_Bel *_/    |_____/  \ __________/________/   A:A   \___/   \___    _______/                            \___       ___|  -------------- |  -------------  |
|~~~~~~~~~~~~~~~~~~~~~~~~~~~~~~~~~~\_          | Pic / \__/  A:A  |      *  |___  A:A Sil |         War    |          \__/                                        \   __/~~~|  A:A Aaa > Aaa  |  A:A Aaa > Aaa  |
|~~~~~~~~~~~~~~~~~~~~~~~~~~~~~~~~~~~~\_  A:A   |____/     |  Ruh_/   A:A   / A:A \_________\__  * _________|___  A:A     \               A:A Sev                   \_/~~~~~~|  A:A Aaa > Aaa  |  A:A Aaa > Aaa  |
|~~~~~~~~~~~~~~A:A~~~~~~~~~~~~~~~~~~~~~\  Bre /  * | A:A  |____/   Mun ___/  Boh     /____    \__/             \   Ukr   /                    __                    /~~~~~~~|  A:A Aaa > Aaa  |  A:A Aaa > Aaa  |
|~~~~~~~~~~~~~~MAO~~~~~~~~~~~~~~~~~~~~~~|____/ A:A | Bur /____________/   \_________/     \____     A:A Gal     |_      /               _____/~_/                   \~~~~~~~|  A:A Aaa > Aaa  |  A:A Aaa > Aaa  |
|~~~~~~~~~~~~~~~~~~~~~~~~~~~~~~~~~~~~~~~|    \ Par |    |        |    A:A  __|_____  * A:A   | \________   ____/  \____/       ___     /~~~~~~/                      \_~~~~~|  -------------  |  -------------  |
|~~~~~~~~~~~~~~~~~~~_______~~~~~~~~~~~~/ A:A  \ __/   _/  _______/ Tyr ___/_____   \__ Vie  /           \_/            \__   _/~~~/ *  \~~~__/                        _\~~~~|  A:A Aaa > Aaa  |  A:A Aaa > Aaa  |
|~~~~~~~~~~~~~~~~~~/   nc  \__~~~~~~__/  Gas __|_____/ \_/  A:A  \____/   A:A   \     \____/   * A:A      \     A:A       \_/~~~~~\____/~~~\________               __/  \_~~|  A:A Aaa > Aaa  |  A:A Aaa > Aaa  |
|~~~~~~~~~~~~~~~~~/___        \____/      __/  A:A      /   Pie    ___\ Ven *___/         \__    Bud       |    Rum  *   _/~~~~~~~~~~~~~~~~~~~~~~~~~\____      ___/       \~|  A:A Aaa > Aaa  |  A:A Aaa > Aaa  |
|~~~~~~~~~~~~~~~~/    \            \_____/    Mar ___* |   _______/    \    |~~~\__*  A:A    \_________   /    _________/~~~~~~A:A~~~~~~~~~~~~~~~~~~~~~~~\____/            \|  A:A Aaa > Aaa  |  A:A Aaa > Aaa  |
|~~~~~~~~~~~~~~_| A:A  |   A:A         \___     _/~~~\__\_/~~~~\____A:A |   _\~~~~~\   Tri    \        \_/  __/        /~~~~~~BLA~~~~~~~~___~~~~~~~~~~___/                  |  A:A Aaa > Aaa  |  A:A Aaa > Aaa  |
|~~~~~~~~~~~~~/  Por  /    Spa             \___/~~~~~~~~~~~~~~~~~~~~\Tus|__/  \~~~~~\__        |__* A:A  \ /   A:A  ec \~~~~~~~~~~~~~~__/   \________/         A:A Arm      |  A:A Aaa > Aaa  |  A:A Aaa > Aaa  |
|~~~~~~~~~~~~|  *  __/                 ____/~~~~~~~~~~A:A~~~~~~~~~/~~\_/ * \_  \__~A:A~\__    /   \  Ser  |    Bul  ____\~~~~~~~~___/                \__                    |  A:A Aaa > Aaa  |  A:A Aaa > Aaa  |
|~~~~~~~~~~~~|    /         *        _/~~~~~~~~~~~~~~~GOL~~~~~~~~~~~~~~\_A:A \ A:A\~ADR~~~\__/ A:A |______|  *    _/     \______/                     __\____               |  A:A Aaa > Aaa  |  A:A Aaa > Aaa  |
|~~~~~~~~~~~~|___/                  /~~~~~~~~~~~~~~~~~~~__~~__~~/~~~~~~~~\Rom | Apu\~~~~~~~~~\ Alb |      _\_ sc / A:A  //  |      A:A Ank  _________/       \______        |  A:A Aaa > Aaa  |  A:A Aaa > Aaa  |
|~~~~~~~~~~~~~~~\__          sc ____\~~__~~__~~__~~__~/~~~~~~~~~~~~~~~~~~~\__/ \___ \__~~~~__~|   /     _/~~~\__|  Con //   |    *  _______/                   /    \___    |  A:A Aaa > Aaa  |  A:A Aaa > Aaa  |
|~~~~~~~~~~~~~~~~~~\_   _______/~~~~~~~~~~~~~~~~~~~~~~~\~~~~~~~~~~A:A~~~~~~~~\__A:A\   \~/~~~~~\ /     /~~~~~~~~~\__/~_/    |______/                     _____/         \___|  A:A Aaa > Aaa  |  A:A Aaa > Aaa  |
|~~~~~~~~~~~~~~~~~~~~\_/~~~~~~~~~~~~~~~~~~A:A~~~~~~~~~~~~~~~~~~~~~TYR~~~~~~~~~~~\Nap\ __|~~~~~~~|  A:A \_~~~A:A~~~~~~/_ *  /               *    ________/                   |  A:A Aaa > Aaa  |  A:A Aaa > Aaa  |
|~~~~~~~~~~~~~~~~______|~~~~~~~~~~~~~~~~~~WES~~~~~~~~~~~~\~~~~~~~~~~~~~~~~~~~~~~~|*  |~~~~~~~~~~~\  Gre  \~~AEG~~~~~|  \__/    A:A Smy    _____/                            |  A:A Aaa > Aaa  |  A:A Aaa > Aaa  |
|~~~~~~~~~~~~~__/      \____~~~~~~______________~~~~~~~~~~___~~~~__~~__~~__~~__~~|__/~~~~~A:A~~~~~|   * _/~~~~~~~~~~~\____       ________/~~~~~\_                           |  A:A Aaa > Aaa  |  A:A Aaa > Aaa  |
|~~~~~~~_____/     A:A      \____/         /    \________/   \~/~~~~~~~~~~~~~~~~~~~~~~~~~~ION~~~~~|____/~\~~__~~__~~/~~~~~\_____/~~~~~~~~~~~~~~~~\           A:A Syr        |                 |                 |
|~~____/            Naf                   /      A:A Tun   *  |~~~~~~~~~~~~~~~~~~~~~~~~~~~~~~~~~~~~~~~~~~~~~~~~~~~~~~\~~~~~~~~~~~~~~~A:A~WES~~~~~~|                         |                 |                 |
|_/______________________________________/_____________________\__________________________________________________________________________________|_________________________|_________________|_________________|